{"ROWS":9,
 "COLS":11,
 "matrix":[["#","#","#","B","#","#","#","#","#","#","#"],
           ["#"," "," "," "," "," "," ","#","a"," ","#"],
           ["#"," ","#","#","#"," ","#","#","#"," ","#"],
           ["#"," ","b","#","#"," "," "," ","#"," ","#"],
           ["#","#","#","#","#","#","#"," ","#"," ","#"],
           ["#"," ","#"," "," "," "," "," ","#"," ","#"],
           ["#"," ","#","#","A","#","#","#","#"," ","#"],
           ["#"," "," "," "," "," "," "," "," "," ","#"],
           ["#","#","#","#","#","#"," ","#","#","#","#"]],
 "exitPoint":{"x":3,"y":0},
 "playerPoint":{"x":6,"y":8}}