{"ROWS":12,
 "COLS":16,
    "matrix":[["#","#","#","C","#","#","#","#","#","#","#","#","#","#","#","#"],
              ["#"," "," "," "," "," "," "," "," "," "," "," "," "," "," ","#"],
              ["#","#"," ","#","#","#","#","B","#","#","#","#","#","#"," ","#"],
              ["#"," ","0"," ","#"," "," "," "," "," "," "," "," ","#"," ","#"],
              ["#"," ","#"," ","#"," ","#"," ","#","#","#","#"," ","#"," ","#"],
              ["#"," "," ","0","#"," ","#"," "," "," "," ","#"," ","#"," ","#"],
              ["#","#","#","#","#"," ","#","#","#","#"," ","#"," ","#"," ","#"],
              ["#"," "," "," "," "," ","#","b","x","#"," ","#","#","#"," ","#"],
              ["#"," ","#"," ","#"," ","#"," "," ","A"," ","#"," "," "," ","#"],
              ["#"," ","#"," ","#"," ","#","#","#","#"," ","#"," ","#","#","#"],
              ["#","a","#"," ","#"," "," "," "," "," "," ","#"," "," ","c","#"],
              ["#","#","#"," ","#","#","#","#","#","#","#","#","#","#","#","#"]],
    "exitPoint":{"x":3,"y":0},
    "playerPoint":{"x":3,"y":11},
    "enemyPoint":{"x":2,"y":5}}